1111111000111111111000000000111111111111
1010001010100000000011111110000000000001
1010101010101111111000000011111111111101
1010101010101000000011111010050000000001
1010101010101011111110001011111101111111
1010101010101000000000101010000000000001
1010101010101111111110101010111111111101
1010101010101000100010101010000000000101
1010101010101010101010101011111111110101
1010101010101010101010101000000000000001
1010001010101010101010101111111111111011
1010101010101010001000100000000000000001
1010101010101011111111111111100000000111
1010101010101000000000000000100000000101
1010101010101111111111111110100000000101
1010101010100000000000000000100000000101
1010101010101111111110011111100000000101
1010101010101000000001010000000000000101
1010101010101011111101010111000000000101
1010101010101010000100010100000000000101
1000100010001010110111110100000000000101
1111110111101000100100000100000000000101
1000010010101111101101111111111000000101
1000010010101000001001000000001111111101
1010110010101011111101001000101000000001
1010000010101010000001101110101000011111
1010111110101010001111000010101010000001
1000000000101011101010011110101011111101
1111111110101000001010001010101000000001
1000000000101111111010111010101110111111
1011011111101000100010000010100000000001
1000000001000010001011111010101111111101
1111111101011111111010001010101000000101
1000000001000000001010101010101101110101
1011011111111111101010101010101000010001
1010000000001010001010101010101110111111
1111111110100010101010101010100000000001
1000010000101010101010100010111111111101
1001040100001000101000100010000000000001
1111111111111111111111111111111111111111
