0000000000000000000000000000000000000000
0000000000000000000000000000000000111100
0000000000000000000000000000000000005100
0000000000000000000000000000000000111100
0000000000000000000000000000000000000000
0000000000000000000000000000000000000000
0000000000000000000000000000000000000000
0000000000000000000000000000000000000000
0000000000000000100000000000000000000000
0000000000000000100000000000000000000000
0000000000000000000000000000000000000000
0000000000000000010000000000000000000000
0000000000000000000000000000000000000000
0000000000000000010000000000000000000000
0000000000000000010111111111111111111100
1111111111111111111000000000000000000100
0000000000000000000000100100000000000000
1111111111111011111111101111111111111111
0000000000000010000000000000010001000000
0000010110010010001111111111110101010000
0000010000001000100000000000000100010000
0000010000000010111111111111111111111000
0111111111001000001000000000000000000000
0000000011111111111111110111111000011100
0000000000000000000000000000001111110000
0000000000000000000000000000000000000000
0000000000000000000000000000000000000000
0000000000000000000000000000000000000000
0000000000000000000000000000000000000000
0000000000000000000000000000000000000000
1111111110000000000000000000000000000000
0000000010000000000000000000000000000000
0000040010000000000000000000000000000000
0000000010000000000000000000000000000000
0110111110000000000000000000000000000000
0000000000000000000000000000000000000000
0000000000000000000000000000000000000000
0000000000000000000000000000000000000000
0000000000000000000000000000000000000000
0000000000000000000000000000000000000000
